------------------------------------------------------------
|.......:::~~~~~~~::::::::::::::...........................|
|.........~~~~~~~~~..................M.....................|
|........~~~~~P~~~~~.......||..........................^^^^|
|..:::::::~~~~~~~~~........................................|
|..........~~~~~~~.....||..............^^^^^...............|
|......................................^...................|
|.....^^^..............................^...................|
|..^^^^^...................................................|
|.....................M........||..........................|
|..............................||..........................|
|..............................||..................||..||..|
|................:::::::.............................||....|
|....................^^^^^^^^^^^^^^^^^^^^^^^....M..........|
|.......:::...............................~~~~~~~::::::::::|
|.......:::..............................~~~~~~~~~.........|
|.......................................~~~~~*~~~~~........|
|..:::::::...............................~~~~~~~~~.........|
|.........................................~~~~~~~..........|
------------------------------------------------------------