............................................................
........:::::::::::::::::...................................
............................................................
.............*...^^.........................................
..:::::::...................................................
.................^^.........................................
............................................................
............................................................
........................................................:...
..............................:........................::...
......................................................::....
.............P.......................................::.....
................:::::::.............................::......
....................^^^^^^^^^^^^^^^^^^^^^^^.................
.........::::...........:::::::::::::::::::.................
............................................................
.................................................^^^^^^^^^^^
....................................................M.......
............................................................
............................................................

