------------------------------------------------------------
|.......:::~~~~~~~::::::::::::::...........................|
|.........~~~~~~~~~..................M.....................|
|........~~~~~@~~~~~.......||..........................^^^^|
|..:::::::~~~~~~~~~........................................|
|..........~~~~~~~.....||..................................|
|..........................................................|
|.....^^^..................................................|
|..^^^^^...................................................|
|.....................M........||.......................||.|
|......................................................||..|
|.....................................................||...|
|................:::::::.............................||....|
|....................^^^^^^^^^^^^^^^^^^^^^^^....M..........|
|.........||...........^^^^^^^^^^^^^^^^^^^^^...............|
|................................P.........................|
|..................................................^^^^^^^^|
|..........................................................|
|..........................................................|
------------------------------------------------------------