------------------------------------------------------------
|.......:::.......::::::::::::::...........................|
|....................................M.....................|
|.............P............||..........................^^^^|
|..:::::::.||...||.........................................|
|......................||..............^^^^^...............|
|......................................^...................|
|.....^^^..............................^...................|
|..^^^^^...................................................|
|.....................M........||..........................|
|..............................||..........................|
|..............................||..................||..||..|
|................:::::::.............................||....|
|....................^^^^^^^^^^^^^^^^^^^^^^^....M..........|
|.......:::...............................~~~~~~~::::::::::|
|.......:::..............................~~~~~~~~~.........|
|.......................................~~~~~*~~~~~........|
|..:::::::...............................~~~~~~~~~.........|
|.........................................~~~~~~~..........|
------------------------------------------------------------